111111111111111111111
100000000010000000C1
1C000010000010101001
1000C00000100E0000011
100100C0000000000C01
10001000000001111001
1P1000C000C1111000C1
11111111111111111111
