111111111111111111111
100000000010000000C11
1C0000100000101010011
1000C00000100E0000011
100100C0000000000C011
10001000000001111001
1P1000C000C1111000C11
111111111111111111111
