111111\n
1CEP11\n
111111\n
100001\n
111111\0