11111111111111111111
1000000000100E0000C1
100000000C0011111001
1000C0000010000000C1
100000000010000000C1
10000000000011111001
1P000000000111100001
11111111111111111111
