1111111111111
100100E0000C1
1000011111001
1P0011C100001
1111111111111
