11111111111111111111
1000000000100E000001
11000010000010101001
1000C000001000000001
100100C0000C00000C01
10000000000011111001
1P0000C000C111100001
11111111111111111111
