11111111111111111111
1000000000100E000001
10000000000011111001
1000C000001000000001
10000000001000000C01
10000000000011111001
1P000000000111100001
11111111111111111111
