1111111111111
100100E0000C1
10C0011111001
10010000000C1
1C010000000C1
1000011111001
1P00111100001
1111111111111
